#################################################
#...............................................#
#...............................................#
#......................@........................#
#...............................................#
#.......b.......................................#
#...............................................#
#...............................................#
#################################################