#################################################
#...B...................................D.......#
#...............................................#
#......................@........................#
#...............................................#
#...............................................#
#.....Q.........................................#
#################################################