#################################################
#...............................................#
#...............................................#
#...............................................#
#...............................................#
#...............................................#
#....@B.........................................#
#################################################