#################################################
#...............................................#
#...............................................#
#.....................Q@........................#
#...............................................#
#...............................................#
#...............................................#
#...............................................#
#################################################