#################################################
#...............................................#
#...............................................#
#.....................B@........................#
#...............................................#
#...............................................#
#...............................................#
#...............................................#
#################################################